111111111111111111111111111111111
1d8a0 5 s 60 a88                1
1b3a  5   6  a32                1                       
1b3a  5   6  a32                1                        
1b3a455676654a32                1
1b3a455676694a32                1
1b3a495676654a32                1
1b3a455676654a32                1
1b3a455676654a32                1
1b3a955676654a32                1
1b3a455676654a32                1
1b3a455676654a32                1
1b3a455676654a32                1
1b3a455676654a32                1
1                               1
1                               1
1                               1
1                               1
1                               1
1                               1
1                               1
1                               1
1                               1
1                               1
1                               1
1               w               1
1                               1
1                               1
1                               1                               

              

