111111111111111111111111111111111
1d8a0 a s a0 a88                1
1b3a  a   a  a32                1                       
1b3a  a   a  a32                1                        
1b3a45a676a54a32                1
1b3345a676a94232                1
1b3349a676a54232                1
1b3345a676a54232                1
1b3345a676a54232                1
1b3395a676a54232                1
1b3345a676a54232                1
1b3345a676a54232                1
1                               1
1                               1
1                               1
1                               1
1                               1
1                               1
1                               1
1                               1
1                               1
1                               1
1                               1
1                               1
1                               1
1               w               1
1                               1
1                               1
1                               1                               

              

