111111111111111111111111111111111
1d8a0 a s a0 a88                1
1b3a  a   a  a32                1                       
1b3a  a   a  a32                1                        
1b3a45a676a54a32                1
1b3a45a676a94a32                1
1b3a49a676a54a32                1
1b3a45a676a54a32                1
1b3a45a676a54a32                1
1b3a95a676a54a32                1
1b3a45a676a54a32                1
1b3a45a676a54a32                1
1b3a45a676a54a32                1
1b3a45a676a54a32                1
1                               1
1                               1
1                               1
1                               1
1                               1
1                               1
1                               1
1                               1
1                               1
1                               1
1                               1
1               w               1
1                               1
1                               1
1                               1                               

              

